Polling Station No.,Total Valid Votes,Votes for NOTA option,No. of Rejected Votes,Total Votes,DMK,AIADMK,Win,Difference(AIADMK-win Vote),"Location and Name of Building in
which Polling Station Located",Polling Area
171,992,3,0,995,890,62,DMK,-828,"SCMC Jubilee Ele.School, Jalalkhan Street, Fort-636001, First
Room, Facing West","Salem (C), D 31, Jalalkhan Street,Salem (C), D 31, Janian Street,Salem (C), D 31,
Mohammad Kasim Street"
182,957,7,0,964,799,104,DMK,-695,"SCMC Middle School, Car Street 2nd Agraharam Salem- 636001, New Terraced Building Middle Wing Facing South","Salem (C), D 32,  Mettu Makkan Street,Salem (C), D 32, Mariamman Koil Street,Salem (C), D 32, Mettu Musjith Street"
192,872,1,0,873,763,72,DMK,-691,"Matharasaiye Karimiyaa Padasalai, Mohammedpura, South
Portion of East Facing Terraced Building","Salem (C), D 33, Muthavallimohammad yahoob street,Salem (C), D33, Market
Street"
176,873,3,0,876,682,145,DMK,-537,"SCMC HSS, Navalar Nedunjelian Road, Fort-636001, Terraced Building Facing West Room No.7","Salem (C), D.31,Habeebstreet,Salem (C), D.31.Chinnasamynaidu Street,Salem (C), D.31.Sannathi Street,Salem (C), D.31.Syedkasim Street"
175,786,4,0,790,637,110,DMK,-527,"SCMC HSS, Navalar Nedunchezhian Road, Fort, Salem-636001,
Terraced Building Facing West, Room No 8","Salem (C), D.31,Dubal Ahamad Street,Salem (C), D.31,Venkatasamy Street"
173,920,1,0,921,685,168,DMK,-517,"SCMC HSS, Navalar Nedunzhilian Road, Fort, Salem-636001, Room No.4 West Facing Terraced Building","Salem (C), D.31, Backside of Gosha Hospital  (Anna Nagar),Salem (C), D.31,Church Compound (Market Street),Salem (C), D.31,Navalar Nedunchezhian Salai,Salem (C), D.31,Paul Street,Salem (C), D.31,Thalaivetti
Muniappan Koil Street"
93,852,1,0,853,647,161,DMK,-486,"SCMC Girls HS, Sagadevapruam, Terraced Building Facing
South, East Wing","Salem (C), D.14,Mulluvadi Makkan Street"
188,819,3,0,822,596,148,DMK,-448,"SCMC Ele.School, Arunachalam Street, New Terraced Building First Room East Side Facing North","Salem (C), D 32, Bazaar Street,Salem (C), D 32, Chenna krishnan Street,Salem (C), D 32, Land behind the Jumma Musjith,Salem (C), D32, Sewage Faram,Salem
(C), K 32, Arunachalam Street"
193,882,6,0,888,624,186,DMK,-438,"SCMC Ele.School, Market Street, Southern side of the School, Facing North, West Wing","Salem (C), D 33, Azhad Street,Salem (C), D 33, Mohammad Pura Street Sandu2,Salem (C), D 33, Mohammad Pura Street1,Salem (C), D 33, Mohammad
PuraStreet Sandu1"
190,992,6,0,998,666,257,DMK,-409,"SCMC Ele.School, Market Street, Southern side of the School
Facing North East Wing","Salem (C), D 33, Mohammad Pura Street2,Salem (C), D 33,
Muthavallimohammad Yahoobstreet"
187,802,5,0,807,560,192,DMK,-368,"SCMC Middle School,Compound Car Street, 2nd Agraharam,
Sanitary Inspectors Office, Terraced Building Facing North West Wing","Salem (C), D 33, Athiaman Street"
83,792,4,0,796,522,202,DMK,-320,"SCMC Ele.School, Manakkadu, Terraced Building Facing South,
East  Wing","Salem (C), D.12,Manakkadu East Street,Salem (C), D.13,Manakkadu West
Vinayakar Street"
60,719,5,0,724,471,185,DMK,-286,"SCMC Middle School, Chinnathirupathi, Terraced Building
Facing South,East Wing","Salem(C), D 8  Annasalai"
4,653,5,0,658,430,146,DMK,-284,"CSI Polytechnic College, Yercaud Main Road, Salem-636007,
West Facing North Wing Room No-117","Salem (C), D.7,TamilnaduHousing Unit,Salem (C), D.7,Thirunagar"
55,826,5,0,831,496,217,DMK,-279,"Jayalakshmi Vidayalaya High School, Near Housing Board, Pallakkadu, South Portion of East Facing Main Building","Salem (C), D 8  Bharathi nagar,Salem (C), D 8  Pallakkadu, Salem (C), D 8 Lakshmipuram, Salem (C), D 8 Vishwankadu"
2,502,3,0,505,365,97,DMK,-268,"CSI Polytechnic College, Yercaud Main Road, Salem-636007,
East Facing Room No-113","Salem (C), D.7.Bharathi Nagar (Yercaud Road)"
230,790,8,0,798,480,215,DMK,-265,"SCMC Ele.School, T.V.K. Road-636003, East Terraced Building
East Portion Facing North","Salem (C), D 35, Devangar Street,Salem (C), D 35, Jothi Talkies Road (Bharathiar
Street),Salem (C), D 35, Kumaran Colony"
5,684,5,0,689,424,171,DMK,-253,"CSI Polytechnic College, Yercaud Main Road, Salem-636007, Southern Terraced Building North Facing Hall-DHG-1","Salem(C), D 7 Meenakshi Nagar,Salem(C), D 7 Meenakshi Nagar TVS Nagar"
231,811,6,0,817,500,252,DMK,-248,"SCMC Ele.School, T.V.K. Road, Salem-636003, West Portion of
South Facing New Terraced Building","Salem (C), D 35, Jothi talkies Road,Salem (C), D 35, Mariudayar Street,Salem (C),
D 35, Sanikuttai Street"
43,744,2,0,746,452,206,DMK,-246,"GHSS, Kannankurichi, Salem-636008, Terraced Facing East
Wester Building Middle Wing Room No 42","Kannankurichi (TP), Ward13, Govindasamy Colony"
70,685,6,0,691,429,184,DMK,-245,"Bharathi Vidyalaya Higher Secondary School Maravaneri, South Side Terraced Building North Facing Room No 57","Salem (C), D.12, CourtRoad (K.A.S.Nagar)"
200,852,7,0,859,506,262,DMK,-244,"SCMC Ele School, Paramakudi Nannusamy Street, Terraced
Building Facing North West Portion","Salem (C), D 35, Thambi Kaliamman Koil Street"
68,607,5,0,612,399,157,DMK,-242,"SCMC Kamaraj Girls HSS, Court Road, Manakkadu, East Portion of North Facing New Terraced Building","Salem (C), D.12,Court Road,Salem (C), D.13,Johnsonpet West Street7,Salem (C), D.13,Johnsonpet West Street8,Salem (C), D.13,Johnsonpet West Street9"
14,712,3,0,715,427,195,DMK,-232,"SCMC Ele.School, Ayyanthirumaligai, Salem-636007, West Portion of North Facing Building","Salem (C), D.7,Collector Bungalow Backside Housing Unit,Salem (C), D.7,Housingunit IyyenThirumaligai,Salem (C), D.7,Yercaud Road Housing
Unit,Salem (C), D.7,YercaudRoad"
80,576,4,0,580,377,146,DMK,-231,"SCMC Kamaraj Girls HSS, Court Road, Manakkadu, Salem- 636007, South Portion of West Facing New Terraced Building","Salem (C), D.12,RajaGanapathi Nagar"
180,832,6,0,838,495,270,DMK,-225,"Gokulanatha Hindu Mahajana Higher Secondary School .
Salem, Terraced Main Building Facing North, Midle Potion Hall No 2","Salem (C), D 29, Dr. Subbarayan Road,Salem (C), D 29, Mettu Agraharam,Salem (C), D 29, Parkstreet"
44,1235,3,0,1238,694,470,DMK,-224,"PUMS, Thamarai Nagar, Kannankurichi., Terraced Building
Facing East, North Wing","Kannankurichi (TP), Ward15,Thamari Nagar"
177,705,9,0,714,426,208,DMK,-218,"Gokulanatha Hindu Mahajana,HSS, Salem Town-636001, Main Terraced Building Facing North Hall No 3","Salem (C), D 29, Bretts Road,Salem (C), D 29, Maraimalai Adikal Street,Salem (C), D 29, Mulluvadi 1,Salem (C), D 29, ThiagiVeeraiya Street Mulluvadi 2"
51,810,6,0,816,468,253,DMK,-215,"Suba Primary School, Mahendrapuri, West Terraced Building East Facing Room No.2","Salem(C), D 8, Athayammal IInd Street,Salem(C), D 8, Kamarajnagar,Salem(C), D 8, Kamatchinagar,Salem(C), D 8, Kattabommanstreet, Karnan street,Salem(C),
D.8.Cholan Street"
81,488,5,0,493,321,107,DMK,-214,"SCMC Ele.School, Manakkadu., Terraced Building Facing West
Eastern side of South Wing","Salem (C), D.12,Manakkadu East Street"
76,712,5,0,717,427,221,DMK,-206,"SCMC Kamaraj Girls HSS, Court Road, Manakkadu, Salem- 636007, North Portion of West Facing New Terraced Building","Salem (C), D.12,Johnsonpet east street1,Salem (C), D.12,Johnsonpet east street3,Salem (C), D.12,Johnsonpet east street4,Salem (C), D.12,Johnsonpeteast
street2,Salem (C), D.13, Subbarayan Layout"
57,935,6,0,941,517,314,DMK,-203,"SCMC Midde School, Chinna Thirupathi, New Terraced Building HM Room Additional Building Facing North","Salem(C), D 8 , Lakashmi Nagar,Salem(C), D 8 Abirami Garden,Salem(C), D 8 Pandiyan Street,Salem(C), D 8 Rajaganapathi Nagar,Salem(C), D 8 Varatharajan Nagar,Salem(C), D 8, Saraswathi Nagar,Salem(C), D 8, Sri Ganapathi Nagar"
227,640,5,0,645,380,177,DMK,-203,"Sowrasthra High School, Chairman Ramalingam Street-636001,
Terraced building west portion facing south","Salem (C), D 35, Newstreet3,Salem (C), D 35, Railwayline South Street"
72,941,10,0,951,510,315,DMK,-195,"Bharathi Vidyalaya Higher Secondary School Maravaneri, South Side Building North Facing Room No 55","Salem (C), D.12, Court Road Pilliar Nagar1,Salem (C), D.12, Court Road Pilliar Nagar2"
1,518,4,0,522,331,139,DMK,-192,"CSI Polytechnic College, Yercaud Main Road, Salem-636007,
East Facing Room No-112","Salem (C), D.7.Bharathi Nagar (Yercaud Road)"
75,753,4,0,757,441,249,DMK,-192,"SCMC Kamaraj Girls HSS, Court Road, Manakkadu, Salem- 636007, West Portion of North Facing Building","Salem (C), D.12, Johnsonpet East Street 9(Kudisai Paguthi),Salem (C),
D.12,Johnsonpet east street5,Salem (C), D.12,Johnsonpet east street6,Salem (C), D.12,Johnsonpet east street7"
7,879,13,0,892,470,291,DMK,-179,"CSI Polytechnic College, Yercaud Main Road, Salem-636007, Southern Terraced Building North Facing Hall-DHG-3","Salem (C), D.7,Kambarstreet"
52,784,8,0,792,419,240,DMK,-179,"Suba Primary School, Mahendrapuri, West Terraced Building East Facing Room No.3","Salem(C), D 8, Asokansalai,Salem(C), D 8, Kalingasalai,Salem(C), D 8, Kambar Street,Salem(C), D 8, Paristreet,Salem(C), D 8, QueensCircle,Salem(C), D 8,
S.C.C.B. Colony,Salem(C), D 8, Sivajisalai, Sibistreet (Prince Circle),Salem(C), D 8, Subbarayansalai,Salem(C), D.8.Meenachi Nagar"
86,633,1,0,634,369,190,DMK,-179,"C.S.I. Hobert Ele. School, Hasthampatty, Salem-636007, West Portion of North Side East Facing Terraced Building","Salem (C), D.13,Govindan Extension,Salem (C), D.13,Johnsonpet Itteri road,Salem (C), D.13,Pazhaniappa Nagar"
24,665,5,0,670,367,190,DMK,-177,"Government Higher Secondary School, Kannankurichi,
Terraced Building West Facing South Wing Room No 29","Salem(C), D 6 Housingunit,Salem(C), D 6 Kattuvalavu"
62,532,5,0,537,319,151,DMK,-168,"SCMC Middle School, Chinnathirupathi, Salem-636008, Terraced Building Facing North","Salem(C), D 8  Kamarajarnagar2nd street,Salem(C), D 8 Kamarajar 2nd street,Salem(C), D 8 Kamarajarnagar 1st street,Salem(C), D 8 Kamrajar 1st
street, Salem(C), D  8  Kamarajar 3 street"
78,441,2,0,443,279,111,DMK,-168,"SCMC Kamaraj Girls HSS, Court Road, Manakkadu, Salem- 636007, East Portion of West Facing New Terraced Building","Salem (C), D.12,Rajanagar"
118,548,4,0,552,322,154,DMK,-168,"SCMC Anganvadi Centre - 217, Kamarajar Colony, Salem,
Northern Terraced Building South Facing","Salem(C), D.16,Govt.Housing Board,Salem(C), D.16,Peramanoor Narayanasamy
Street"
61,803,4,0,807,429,265,DMK,-164,"Jairam Higher Secondary School Chinnathirupathi, West Facing Terraced Building Room No 9","Salem(C), D 8  Santhinagar,Salem(C), D 8  Srinivasanagar,Salem(C), D 8 Santhosh Nagar,Salem(C), D 8, Ishwariya Garden,Salem(C), D 8, Vaishnavi Garden"
137,515,5,0,520,301,140,DMK,-161,"St.Marys Girls HSS, Arisipalayam, IIIrd Room FromThe Main
Building  East Side,Facing North","Salem (C), D.27, Narayanasamipuram St,Elango St, (Housing Unit),Salem (C),
D.27,Chinnababustreet,Salem (C), D.27,Veeran Nilam"
40,885,9,0,894,470,310,DMK,-160,"GHSS, Kannankurichi, Salem-636008, East Portion of South Facing Terraced Building Room No 24","Kannankurichi (TP), Ward13, MarimuthuStreet,Kannankurichi (TP), Ward13, PethanStreet,Kannankurichi (TP), Ward14, Pacharoad Yercaud main Road"
260,1075,10,0,1085,570,410,DMK,-160,"SCMC Middle School, Allikuttai, Salem-636003, South Portion
of West Facing New Terraced Building","Salem (C), D,9, venkatachalam colony"
74,737,6,0,743,415,256,DMK,-159,"SCMC Kamaraj Girls HSS, Court Road, Manakkadu, Salem-
636007, South Facing New Terraced Building","Salem (C), D.12, Johnsonpet East Street8,Salem (C), D.13, Rajamanickam Street"
82,600,3,0,603,346,187,DMK,-159,"SCMC Ele.School, Manakkadu, Terraced Building Facing South,
West wing","Salem (C), D.12,Manakkadu East Street"
87,532,2,0,534,317,158,DMK,-159,"GHS, A.R.Line, Kumarasamipatty, Cherry Road, Salem-636007, Terraced Building Facing West, Middle Wing Room No 5","Salem (C), D.14,Kumarasamypatty cherry road,Salem (C), D.14,Sulthanline"
54,674,2,0,676,381,224,DMK,-157,"Anderson Matric Hr.Sec.School, Sengodagounder salai Salem, West Facing Terraced Building East Room No.5A","Salem (C), D 8 Jayapal line,Salem (C), D 8 Rajeev Nagar,Salem (C), D 8 Rathinapuri,Salem (C), D 8 Seetha Garden,Salem (C), D 8 Sengodagounder Salai
,North,Salem (C), D 8Anbu Nagar,Salem (C), D 8 Mepillavar Garden"
77,806,1,0,807,438,281,DMK,-157,"Bharathi Vidyalaya Higher Secondary School Maravaneri,
Room No 36 Leap 2004 Block Facing South","Salem (C), D.12,Chinnathirupathy Road,Salem (C), D.12,Court Road
Colony,Salem (C), D.12,Kakkayankadu"
126,389,1,0,390,251,98,DMK,-153,"SCMC 27th Division Sanitary Inspector Office, Velasamy Street, (Rajendra Chatram Compound), Facing South West Portion
Terraced Building","Salem (C), D.27,Pavendar Street,Salem (C), D.27. Seetharaman Street (Slump Area),Salem (C), D.27Seetharaman Street"
69,771,5,0,776,417,266,DMK,-151,"SCMC Kamaraj Girls HSS, Court Road, Manakkadu, New
Building Facing South Eastern Portion IInd Room","Salem (C), D.12,Pilliar Nagar 3,Salem (C), D.13,Manakkadu Itteri Road"
229,887,6,0,893,462,312,DMK,-150,"SCMC Ele.School, T.V.K. Road, Salem-636003, New Terraced Building facing North, East Wing","Salem (C), D 35, Jothi Talkies Road,Salem (C), D 35, Jothi Talkies South Street2 (Balaji Nagar 2, 3rd Cross),Salem (C), D 35, Jothi Talkies South Street2 (Balaji Nagar 4th Cross),Salem (C), D 35, Jothi Talkies South Street3, (Angalamman
Street)"
30,591,3,0,594,336,192,DMK,-144,"PUMS, Kannankurichi, Salem-636008, New Terraced Building Facing East North Wing","Kannankurichi (TP), Ward4, Desaichinnaponnustreet,Kannankurichi (TP), Ward4, Gopal Street,Kannankurichi (TP), Ward4, Karuppannan Street,Kannankurichi (TP), Ward4, Natarajan Street,Kannankurichi (TP), Ward4, PannaiarSubbarayan Street,Kannankurichi (TP), Ward4, Venkatachalam Street"
58,697,10,0,707,368,231,DMK,-137,"SCMC Middle School, Chinna Thirupathi., Facing West,
Terraced Building North Wing.","Salem(C), D 8 Gurukkal Colony,Salem(C), D 8 P.T.Colony,Salem(C), D 8
Sevigounder Street, Thiruvalluvar salai"
37,1084,2,0,1086,584,449,DMK,-135,"GHSS, Kannankurichi, Terraced Building Facing North West Wing Room No.37","Kannankurichi (TP), Ward8, Arunachalam Street,Kannankurichi (TP), Ward8, Govindan Street,Kannankurichi (TP), Ward8, Kaliammankoil Street,Kannankurichi (TP), Ward8, Selvam Street,Kannankurichi (TP), Ward9, Chinnannan Street,Kannankurichi (TP), Ward9, LakshmananColony,Kannankurichi (TP), Ward9, Sathyacolony,Kannankurichi
(TP), Ward9, Yerappan Street"
35,735,3,0,738,392,265,DMK,-127,"PUMS, Kannankurichi, Southern Terraced Building Facing North","Kannankurichi (TP), Ward12, Arumugam Ayyer Street,Kannankurichi (TP),
Ward12, Karpagam Nagar (Rajnagar),Kannankurichi (TP), Ward12, Venkateswara Nagar,Salem  (C), D 8, Yercaud Road"
154,814,2,0,816,444,318,DMK,-126,"St.Patricks Primary Gilrs School ABL, I-D, , Shevapet, Salem- 636002, Facing South Terraced Building Middle Wing","Salem (C), D.28, Gandhi Nagar,Salem (C), D.28,Gandhi Nagar (Appartment House),Salem (C), D.28,Gandhinagar Kudisai Paguthi,Salem (C), D.28,Singarapet"
181,898,10,0,908,470,344,DMK,-126,"Gokulanatha Hindu Mahajana Higher Secondary School . Salem, Terraced Main Building Facing North, Western Portion
Hall No 4","Salem (C), D 29, Cherarajan Road,Salem (C), D 29, MettuMariyamman Koil Street,Salem (C), D 29, Pandiarajan Street,Salem (C), D.29, Serarajan St.
Appartments"
42,748,5,0,753,409,284,DMK,-125,"GHSS, Kannankurichi, Salem-636008, Terraced Facing East
Western Building Middle Wing Room No 41","Kannankurichi (TP), Ward1, SeviColony,Kannankurichi (TP), Ward13,
Govindasamy Street,Kannankurichi (TP), Ward2, Saravana Nagar"
183,764,4,0,768,409,288,DMK,-121,"SCMC Middle School, Car Street 2nd Agraharam Salem- 636001, New Terraced Building West Wing Facing South","Salem (C), D 32 , Angalaman koil street,Salem (C), D 32, Chairman Rajarathinam Street,Salem (C), D 32, First Agraharam,Salem (C), D 32, First Agraharam River
Side Street"
85,553,8,0,561,314,195,DMK,-119,"C.S.I. Hobert Ele. School, Hasthampatty, Salem-636007, West Portion of South Side East Facing Terraced Building","Salem (C), D.13,Hasthampatty main road,Salem (C), D.13,Kalaivanar Street,Salem (C), D.13,Kullar street"
179,741,7,0,748,387,268,DMK,-119,"Gokulanatha Hindu Mahajana,HSS, Salem-636001, Terraced Main Building Facing North, Western Portion Hall No 5","Salem (C), D.29,Andal Street,Salem (C), D.29,Kannan Street,Salem (C), D.29,Mettu Pilliar Koil Street,Salem (C), D.29,Somu Street,Salem (C),
D.29,Srinivasan Street"
152,803,8,0,811,413,295,DMK,-118,"Jayarakini Boys Middle School, Salem-636002, East Portion RoomNo.4 of South Facing North Side Terraced Building","Salem (C), D.28,Chairman Rathinasamy Street,Salem (C), D.28,Madhakoil Street,Salem (C), D.28,Old Market Street"
164,783,6,0,789,428,313,DMK,-115,"SCMC High School, Appu Street, Shevapet, Salem-636002, 2nd Room From East Side of North Facing Terraced Building","Salem (C), D 30, Karikalan Street,Salem (C), D 30, Nagaier Street,Salem (C), D.30,
Baikara Street,Salem (C), D.30, Majeeth Street,Salem (C), D.30, Mukdhumstreet,Salem (C), D.30, Syedkadhar Street"
232,1116,4,0,1120,560,446,DMK,-114,"SCMC Ele.School, T.V.K.Road, Salem-636003, West Facing
Anganwadi Block New Building","Salem (C), D 35, Jothitalkies west street"
67,551,0,0,551,311,200,DMK,-111,"SCMC Kamaraj Girls HSS, Court Road, Manakkadu, Terraced Building Facing West of East Side Building","Salem (C), D.13,Johnsonpet West Street1,Salem (C), D.13,Johnsonpet West Street2,Salem (C), D.13,Johnsonpet West Street3,Salem (C), D.13,Johnsonpet West Street4,Salem (C), D.13,Johnsonpet West Street5,Salem (C),
D.13,Johnsonpet West Street6"
19,686,6,0,692,361,254,DMK,-107,"Mountmary s Matriculation School, Periyar Nagar (Room No.6) Chinnakollapatty,  North Terraced Building - South facing
Room No.9","Salem(C), D 6  K.K.Nagar West,Salem(C), D 6 K.K.nagar,Salem(C), D 6 Ponn Nagar West,Salem(C), D 6 PonnNagar East,Salem(C), D 6 Yercaud Main Road
West"
34,570,11,0,581,299,193,DMK,-106,"PUMS, Kannankurichi, Terraced Building Facing West Middle
Wing","Kannankurichi (TP), Ward12, Mahalakshmi Nagar,Kannankurichi (TP), Ward12,
Salem Road,Salem  (C), D 8, M.G.R.Nagar"
247,974,10,0,984,478,374,DMK,-104,"SCMC Adhiselvan Ele. School, Ammapet, Salem-636003, New Terraced Building Facing North 2nd Room of Centre Portion","Salem (C), D 36, Cuddalore Main Road North Extension"
26,825,4,0,829,400,298,DMK,-102,"SCMC Ele. School, Periya Kollapatty, Salem-636008, Terraced
Building Facing North East Wing","Salem(C), D 6  Prakasam nagar mariammankoil melvattam,Salem(C), D 6
Kannankurichi Main Road and vijay Nagar"
22,913,4,0,917,457,357,DMK,-100,"Mountmary s Matriculation School, Periyar Nagar (Room No.4) Chinnakollapatty, Terraced Building Facing South, Middle Wing","Salem(C), D 6  Kundathumedu,Salem(C), D 6  N.G.G.O.Colony,Salem(C), D 6 Santhinagar"
139,854,8,0,862,425,326,DMK,-99,"SCMC 26 Division Sanitary Inspector Office, Periyakinaru Street, Saminathapuram, Terraced Building Facing East","Salem (C), D.26,Dr. Rathinam Street,Salem (C), D.26,Maruthanayagam Street,Salem (C), D.26.Periakinaru Street"
32,609,2,0,611,329,231,DMK,-98,"PUMS, Kannankurichi Salem-636008, Terraced Building Facing West, Eastern Side of South Wing","Kannankurichi (TP), Ward5, Dasaramarimuthu Street,Kannankurichi (TP), Ward5, Muthusamy Street,Kannankurichi (TP), Ward5, Narayanan Street,Kannankurichi (TP), Ward5, Pazhaniappan Street,Kannankurichi (TP), Ward5, Selvam Street,Kannankurichi (TP), Ward5, StreetNo.6,Kannankurichi (TP), Ward5, StreetNo.8,Kannankurichi (TP), Ward5, T.K.V. Rajagopal Street,Kannankurichi (TP), Ward5, V.K.Perumal Street,Kannankurichi (TP), Ward6, Chinna Mariamman Koil Street,Kannankurichi (TP), Ward6, K.R.Ezhumalai Street,Kannankurichi (TP), Ward6, Kunjan Street,Kannankurichi (TP), Ward6, Subbu Street,Kannankurichi (TP), Ward6, Thambu Street"
258,883,12,0,895,426,331,DMK,-95,"SCMC Middle School, Thathampatty, South Facing West Portion Terraced Building","Salem (9), D,9, Tank street,Salem (C), D,9, Periyanna Udayar street,Salem (C), D,9, S.K.Township,Salem (C), D,9, Society street,Salem (C), D.9. Soolakara
Udayar street"
59,856,6,0,862,419,326,DMK,-93,"SCMC Middle School, Chinna Thirupathi, Salem-636008, West Facing Terraced Building South Portion","Salem(C), D 8  Rani Annanagar Kattuvalavu,Salem(C), D 8 Chandran Gardan,Salem(C), D 8 Indiragandhi Street,Salem(C), D 8 Iyyam Perumal Street,Salem(C), D 8 Mariyamman Kovil Street,Salem(C), D 8 Rani Anna Nagar"
73,589,4,0,593,305,216,DMK,-89,"SCMC Kamaraj Girls HSS, Court Road, Manakkadu, The New
Terraced Building Facing South","Salem (C), D.12, Johnsonpet East Street9,Salem (C), D.12,Court Road
(Manakkadu)"
110,932,6,0,938,446,361,DMK,-85,"Cluny Matriculation HSS, Pudur Extension, Terraced Building Northern Side Facing South 4th Room (XII-B Class Room)","Salem (C), D.15, Puthur Extension,Salem (C), D.16, Nagammal Thottam,Salem (C), D.16, Pudur Kallanguthu"
134,827,9,0,836,392,308,DMK,-84,"SCMC Ele.School, Perumal Street, Arisipalayam, South Side
Class Room Facing West","Salem (C), D.26,Christian pet,Salem (C), D.26,Perumal Street,Salem (C),
D.26,R.D.Paul Street"
174,804,2,0,806,410,326,DMK,-84,"SCMC HSS, Navalar Nedunzhilian Road, Fort, Salem-636001,
Room No.20 of North Facing Terraced Building","Salem (C), D.31, Backside of Gosha Hospital  (Anna Nagar),Salem (C),
D.31,Market Street"
79,671,2,0,673,334,255,DMK,-79,"Bharathi Vidyalaya Higher Secondary School Maravaneri, East
Facing Main Building Room No 4","Salem (C), D.12, Courtmain  Road,Salem (C), D.12,Kakkayankadu, Court road,
Colony"
245,1072,4,0,1076,532,455,DMK,-77,"SCMC Indiragandhi HSS, T.V.K. Road, South Portion Terraced
Building Facing East","Salem (C), D 36, Nanjampatty Sekkizhar Street"
11,686,1,0,687,341,265,DMK,-76,"CSI Hobert GHS School Hasthampatty Salem-636007, Facing South Terraced Bulding Middle Portion","Salem (C), D 13, Christian Pet, Adaikala Nagar,Salem (C), D 13, Hasthampatti Mariamman Koil Street,Salem(C), D.13, Central Jail QuartersHousing Unit"
222,679,5,0,684,342,269,DMK,-73,"SCMC High School, Sengal Anai Road, Salem-636001, South
Facing Terraced Building East Wing","Salem (C), D 10, Puthumariamman Koil Street3"
223,678,5,0,683,337,266,DMK,-71,"Sowrastra High School, Chairman Ramalingam Street, Salem- 636001, East Portion of East Facing New Terraced Building","Salem (C), D 34, Kulasekara Azhwar Street,Salem (C), D 35, Railwayline South Street"
45,1030,10,0,1040,509,439,DMK,-70,"PUMS, Kannankurichi, Terraced Building Facing East Middle
Portion","Kannankurichi (TP), Ward11, Kesavannagar,Kannankurichi (TP), Ward11,
Melmottankurichi"
119,683,2,0,685,322,252,DMK,-70,"SCMC Anganvadi Centre - 311, Kamarajar Colony, Salem,
Southern Terraced Building West Facing","Salem(C), D.16,Govindakounder Thottam"
136,563,4,0,567,272,202,DMK,-70,"St. Marys Girls HSS, Arisipalayam, IInd Room From The Main
Building East Side,Facing North","Salem (C), D.26,Malli Street,Salem (C), D.27,Arisipalayam main road"
48,831,5,0,836,398,330,DMK,-68,"PUE School, Ramanathapuram, Kannankurichi, Salem-636008, West Portion of South Facing New Terraced Building","Salem(C), D 8, Bungalow Nagar,Salem(C), D 8, Indiranagar,Salem(C), D 8, Nithyanagar2nd Street,Salem(C), D 8, Nithyanagar2nd Street Extension,Salem(C), D 8, Pandianstreet,Salem(C), D 8, Santhiavenue,Salem(C),
D8,Nithiyanagar 1st"
138,808,7,0,815,379,311,DMK,-68,"St.Marys Girls HSS, Arisipalayam, IVth Room from the Main
Building East Side, Facing North","Salem (C), D.27,Bajanai madam Street,Salem (C), D.27,Lada kuppu street,Salem
(C), D.27,Narayanasamipuram"
71,810,6,0,816,385,318,DMK,-67,"Bharathi Vidyalaya Higher Secondary School Maravaneri, South Side Building North Facing Room No 56","Salem (C), D.12, Gandhinagarmaravaneri,Salem (C), D.12,Court Road (Pilliar Kovil Street),Salem(C), D.12, Courtroad Pilliar Nagar"
112,902,2,0,904,416,351,DMK,-65,"Cluny Matriculation HSS, Pudur Extension, Centre Portion of the Terraced Building Facing North 1st Room (X-A Class Room)","Salem (C), D.15,Subramaniapuram,Salem (C), D.16,Ambedkar Street"
235,633,7,0,640,314,250,DMK,-64,"Village Chavadi, TVK.Road-636003, Tiled  Building Facing south","Salem (C), D 35, Jothitalkies road east street"
49,905,6,0,911,432,369,DMK,-63,"SCMC Ele.School, Ramanathapuram, Kannankurichi, Salem- 636008, East Portion of South Facing New Terraced Building","Salem(C), D 8, Athayammal 1st Street,Salem(C), D 8, Balajinagar,Salem(C), D 8, Mullainagar,Salem(C), D 8, Ramanathapuram"
31,980,1,0,981,477,415,DMK,-62,"PUMS, Kannankurichi, Salem-636008, South Portion of East Facing Terraced Building","Kannankurichi (TP), Ward3, AC Gopal Street,Kannankurichi (TP), Ward3, Arumugam Street,Kannankurichi (TP), Ward3, KurichaNarayanan Street,Kannankurichi (TP), Ward3, L.B.Chetty Street,Kannankurichi (TP), Ward3, Natarajan Street,Kannankurichi (TP), Ward3, R.K.Ramanujam Street,Kannankurichi (TP), Ward3, Subbarayan Street,Kannankurichi (TP),
Ward3, Sundaram Street"
191,623,9,0,632,312,252,DMK,-60,"Matharasaiye Karimiyaa Padasalai, Mohammedpuraa, Tiled
Building Facing North, North Wing","Salem (C), D 33, Mohammadpura Street3,Salem (C), D 33, Valmeegi Street"
89,597,7,0,604,306,248,DMK,-58,"SCMC Ele.School, Kumarasamypatty,Cherry Road, Salem-
636007, Facing West Terraced Building North Wing","Salem (C), D.14,Angalamman Kovil Street,Salem (C), D.14,Kumarasamypatty
west street3,Salem (C), D.14,Manickam Street"
226,836,2,0,838,420,366,DMK,-54,"Sowrastra Primary School, Chairman Sadagopan Street,,
Terraced Building West Facing East Side Main Hall","Salem (C), D 35, Railway Line South Street"
123,558,1,0,559,269,216,DMK,-53,"Little Flower Metriculation School, Chairman Thammannan Road, Salem-636009, North Facing 2nd Room from East Side","Salem (C), D.27, Omalur Road,Salem (C), D.27,Omalur Road (Rathinasamipuram)"
114,557,3,0,560,264,212,DMK,-52,"Cluny Matriculation HSS, Pudur Extension, Salem-636007, Centre Portion of the Terraced Building Facing North 3rd Room
(X-C Class Room)","Salem (C), D.16,Narayanan Street"
16,851,17,0,868,395,347,DMK,-48,"SCMC Middle School, Chinna Kollapatty., Terraced Building
Facing South,  West Wing","Salem(C), D 6 AnnaiIndiranagar,Salem(C), D 6 Iyanarkoilkattuvalavu,Salem(C), D
6 Thiruvalluvar street (south)"
116,791,2,0,793,371,323,DMK,-48,"Cluny Matriculation HSS, Pudur Extension, Salem-636007, Centre Portion of the Terraced Building Facing North 5th Room
(XI-C Class Room)","Salem (C), D.16, Peramanoor Narayanasamy Street"
218,588,8,0,596,286,240,DMK,-46,"SCMC Ele School, Sengal Anai Road, Salem-636001, North
Facing New RMSA Building Room no 5","Salem (C), D 10, Puthumariamman Koil Street1"
104,597,16,0,613,265,227,DMK,-38,"SCMC 15th Divn Sanitary Inspectors Office Sivasamypuram No 2 Srirangapalayam Salem-636007, West Portion of South
Facing Building","Salem (C), D.15, Peramanoor East Street"
33,529,5,0,534,266,230,DMK,-36,"PUMS, Kannankurichi, Terraced Building Facing West, North wing","Kannankurichi (TP), Ward5, Perumal Street,Kannankurichi (TP), Ward5, StreetNo.5,Kannankurichi (TP), Ward6, K.S.Arumugam Street,Kannankurichi (TP), Ward6, K.V.Annamalai Street,Kannankurichi (TP), Ward6, Kannia Street,Kannankurichi (TP), Ward7, Poomalai Street,Kannankurichi (TP), Ward7,
Santhastreet"
210,744,8,0,752,348,313,DMK,-35,"Indian Institute of Handloom Technology, Ponnammapet, Salem-636001, Terraced Building Facing South West Portion
Second Room (Part)","Salem (C), D 11, Malli Street,Salem (C), D 11, Mariyamman Koil Street,Salem (C), D 11, Thillai Nagar Road 5"
102,442,5,0,447,207,175,DMK,-32,"SCMC 15th Divn Sanitary Inspectors Office Sivasamypuram No 2 Srirangapalayam Salem-636007, East Portion of South Facing
Main Building","Salem (C), D.15,Seerangapalayam,Salem (C), D.15,Seerangapalayam East Street"
142,940,5,0,945,417,386,DMK,-31,"Integrated Child Development Centre (Anganwadi) Alraj Street Saminathapuram Centre 51, Divisin 2, Terraced Building Facing
South","Salem (C), D.26,Gowramma Colony,Salem (C), D.26,Rajendramill Colony,Salem (C), D.26,Saminathapuram (Alraj Street)"
117,430,5,0,435,197,169,DMK,-28,"Cluny Matriculation HSS, Pudur Extension, Salem-636007, Centre Portion of the Terraced Building Facing North 6th Room
(I'st A Class Room)","Salem (C), D.16, Peramanoor Narayanasamy Street"
56,962,9,0,971,428,401,DMK,-27,"SCMC Midde.School, Chinna Thirupathi, Facing South Terraced Building West Wing.","Salem(C), D 8 Seran Street,Salem(C), D 8 Solan Street,Salem(C), D 8 Srinivasan
Nagar,Salem(C), D 8 Thiruvalluvar Salai,Salem(C), D 8, Gogul Nagar,Salem(C), D 8, Ragavan Street"
41,963,4,0,967,457,432,DMK,-25,"GHSS, Kannankurichi, New Terraced Building Facing East South
Wing Room No 40","Kannankurichi (TP), Ward13, Kandasamy Street,Kannankurichi (TP), Ward2,
PachiammanNagar"
135,668,2,0,670,287,263,DMK,-24,"St. Marys Girls HSS, Arisipalayam, 1st Room From the Main Building of Facing North","Salem (C), D.26, Syed kadhar Street,Salem (C), D.26, Syedjaffer Street,Salem (C), D.27, Omalur Main Road,Salem (C), D.27, Parvathipuram Layout"
151,596,2,0,598,277,254,DMK,-23,"Jeyarakini Boys Middle School, Santhaipettai Main Road- 636002, Northern Side building IInd Room From West Side
Facing South","Salem (C), D 28, Chairman Madurai Street,Salem (C), D 28, Chinnamaran Street,Salem (C), D 28, Subramanian Street"
127,659,5,0,664,303,281,DMK,-22,"SCMC 27th Division Sanitary Inspector Office, Velasamy Street, (Rajendra Chatram Compound), East Portion of South Facing
Terraced Building","Salem (C), D.27,Mariamman koil Street,Salem (C), D.27,Nagalingam Street,Salem (C), D.27,Velasamy Street"
133,580,8,0,588,252,233,DMK,-19,"SCMC Middle School, Damodharan Street,  Arisipalayam, New Terraced Building North Portion Facing West","Salem (C), D.26,Gunabalaramasamy Street,Salem (C), D.26,Krishnan Street,Salem (C), D.26,Muthusamy Street,Salem (C), D.26,Pappaian Street,Salem (C), D.26,Syed Azhad Street,Salem (C), D.26,Syedkapur Street,Salem (C), D.26,Syedrahim street,Salem (C), D.27,Leighbazaar Street
Railwaycolony"
257,1036,2,0,1038,479,460,DMK,-19,"SCMC Middle School, Thathampatty, Facing South Terraced Building East Wing","Salem (C), D,9, Bajanai madam street,Salem (C), D,9, Eari street,Salem (C), D,9, Kandasamy kovil street,Salem (C), D,9, Manmatharajan street,Salem (C), D,9, Mariamman kovil street,Salem (C), D,9, Samy nagar,Salem (C), D,9. Kannadiar
street"
237,843,5,0,848,379,361,DMK,-18,"SCMC Middle School, Ellappan Street, Salem-636003, Terraced Building Facing South Eastern Wing","Salem (C), D 35, Military Road,Salem (C), D 36, Azhagappan Street,Salem (C), D 36, Desigan Street,Salem (C), D 36, Venkatachalam Street"
94,575,7,0,582,263,246,DMK,-17,"SCMC Girls HS, Sagadevapruam-636007, IInd Terraced building
facing south Eastern portion Middle Wing","Salem (C), D.14,Rajaram Nagar"
99,550,3,0,553,270,253,DMK,-17,"SCMC Ele.School, Kumarasamypatti, Ram Nagar No 1, Northern Portion of the Main Terraced Building Facing East","Salem (C), D.15,Kumarasamypatty West Street1"
115,374,4,0,378,175,158,DMK,-17,"Cluny Matriculation HSS, Pudur Extension, Salem-636007,
Centre Portion of the Terraced Building Facing North 4th Room (X-D Class Room)","Salem (C), D.16,Peramanoor Narayanasamy Street"
10,763,6,0,769,333,318,DMK,-15,"CSI Hobert GHS School Hasthampatty Salem-636007, Facing
South Terraced Building Middle Portion","Salem (C), D.13,Central Jail Backside"
88,440,6,0,446,206,193,DMK,-13,"GHS, A.R.Line, Kumarasamipatty, Cherry Road, Salem-636007,
Terraced Building Eastern Side Facing West (Room No.6) North Wing","Salem (C), D.14,Kumarasamypatty East Street,Salem (C), D.14,Reserve Line"
8,633,2,0,635,280,276,DMK,-4,"CSI Polytechnic College, Yercaud Main Road, Salem-636007, Southern Terraced Building North Facing Hall-DHG-4","Salem (C), D.7,Backside of S.P.Bungalow,Salem (C), D.7,Kambarstreet (Pachudayarkadu),Salem (C), D.7,Pallakkadu,Salem (C), D.8,Vasanthapuram"
202,364,3,0,367,161,158,DMK,-3,"SCMC Ele. School, Paramakudi Nannusamy Street, Salem- 636001, Terraced Building West Portion Facing East South
Wing","Salem (C), D 34, Theerthagiri Road"
209,645,8,0,653,283,282,DMK,-1,"Indian Institute of Handloom Technology, Ponnammapet, Salem-636001, 2nd Room from South Facing West Portion of
New Terraced Building","Salem (C), D 11, Kuppu Street,Salem (C), D 11, Pandam Ramasamy Street"
244,976,6,0,982,445,444,DMK,-1,"SCMC Indiragandhi HSS, T.V.K. Road, Terraced Building Facing
East South Portion Room No.3","Salem (C), D 36, Nanjampatty sekkilar street (Parisumudaliarkadu),Salem (C), D
36, Nanjampatty Slum"
29,897,14,0,911,394,394,AIADMK,0,"SCMC Ele.School, Self Sufficienty Scheme  Periya Kollapatty, Terraced Building Facing South West Portion","Salem(C), D 6  Judge road Indira nagar,Salem(C), D 6  Ramanathapuram
,Kannankurichi main road,Salem(C), D 6  Ramasamy nagar Ist Cross,Salem(C), D 6 Kalyani nagar1,2,Salem(C), D 6 Nataraj nagar and judge road south side,Salem(C), D 6 Perumal koil thottam"
38,1006,5,0,1011,462,464,AIADMK,2,"GHSS, Kannankurichi, Terraced Building Facing South Terraced
Building Middle Portion Room No.17","Kannankurichi (TP), Ward1, Kattuvattam"
53,730,2,0,732,329,332,AIADMK,3,"Anderson Matric Hr.Sec.School, Sengodagounder salai Salem,
West Terraced Building East North Wing","Salem (C), D 8 Atthukadu,Salem (C), D 8 Atthukadu,karadu,Salem (C), D 8
Pandiyan street,Salem (C), D 8 Yercaud Road"
101,866,3,0,869,376,380,AIADMK,4,"SCMC Anganvadi Centre - 328, Ram Nagar,, Southern Terraced
Building East Facing","Salem (C), D.15,Ramnagar,Salem (C), D.15,Ramnagar Odai (Temporary
Houses),Salem (C), D.15,Ramnagar Odai Area"
141,780,3,0,783,333,342,AIADMK,9,"SCMC Middle School, Dhamodaran Street Arisipalayam Salem- 636009, North Facing Terraced Building West Wing","Salem (C), D.26,Annamalai Street,Salem (C), D.26,Anthonysamy Street,Salem (C), D.26,Rajakannu Street,Salem (C), D.26,Saminathapuram Main Road"
172,984,9,0,993,438,447,AIADMK,9,"SCMC Jubilee Ele.School, Jalalkhan Street, Fort-636001, Second Room Facing South","Salem (C), D 31, Syedjalalkhan Street,Salem (C), D.31,Christian Pet,Salem (C), D.31,Ram Nagar(Cristianpet),Salem (C), D.31,Thuppakkisalai,Salem (C),
D.31,Varadhappan Street"
266,738,7,0,745,318,329,AIADMK,11,"SCMC Middle School, Allikuttai, New Terraced Building Facing
South","Salem (C), DIV9, Gandhi nagar"
103,462,6,0,468,187,199,AIADMK,12,"SCMC 15th Divn Sanitary Inspectors Office Sivasamypuram No
2 Srirangapalayam Salem-636007, North Portion of South Facing Building","Salem (C), D.15,Peramanoor Main Road,Salem (C), D.15,Seerangapalayam West Street"
246,273,2,0,275,113,127,AIADMK,14,"SCMC Adhiselvan Ele. School, Ammapet, Salem-636003,
Terraced Building Facing North 1st Room","Salem (C), D 36,CuddaloremainRoad NorthExtension(Bharathi St)"
228,740,11,0,751,318,333,AIADMK,15,"SCMC Ele.School, T.V.K. Road, Terraced Building Facing West South Portion","Salem (C), D 35, Jothi Talkies South Street 1 (Balaji Nagar 1st Cross),Salem (C), D 35, Jothi Talkies South Street1,Salem (C), D 35, Jothi Talkies South Street1 (Balaji Nagar Main Road),Salem (C), D 35, Jothi Talkies South Street1 (Karthik Nivas),Salem (C), D 35, Jothi Talkies South Street1, (Balaji Nagar 4th Cross),Salem (C), D 35, Jothi Talkies South Street2,Salem (C), D 35, Jothitalkies west street(Pallukuchi Street)"
140,925,13,0,938,397,413,AIADMK,16,"Integrated child development centre (Anganwadi) Manickam
Street,, Terraced Building Facing West","Salem (C), D.26, Manickam Street,Salem (C), D.26,Arthanari Street,Salem (C),
D.26.Vaithilingam Street"
189,742,6,0,748,313,331,AIADMK,18,"SCMC Ele. School, Arunachalam Street, New Terraced Building
3rd Room West Wing Facing North","Salem (C), D 32, Kamarajar Street,Salem (C), D 32, Musjith Street,Salem (C), D
32, Periyar Street,Salem (C), D 33, BazaarStreet"
211,696,5,0,701,309,327,AIADMK,18,"SCMC Ele. School, Sengal Anai Road, Salem-636001, East
Portion of South Facing Terraced Building","Salem (C), D 10, P.L.Gopal Street"
20,816,3,0,819,359,378,AIADMK,19,"Mountmary s Matriculation School, Periyar Nagar (Room No.6) Chinnakollapatty, Terraced Building Facing South, Middle Wing","Salem(C), D 6  Periyar nagar,Salem(C), D 6 Rajaganapathy nagar"
194,708,8,0,716,307,326,AIADMK,19,"SCMC Urudhu Ele. School,Paavadi Vellakuttai-636001, South
Side Hall Facing East","Salem (C), D 32, Govindan Street,Salem (C), D 33, Kallanguthu Street,Salem (C),
D 33, Subramanian Street"
213,574,6,0,580,239,258,AIADMK,19,"SCMC High. School, Sengal Anai Road, Salem-636001, Western
Side Terraced Building Facing South","Salem (C), D 10, Sengal Anai Road,Salem (C), D 10, Veeranam Main Road"
66,816,7,0,823,351,371,AIADMK,20,"SCMC Middle School, Chinnathirupathi, Salem-636008,
Asbestas Building Noon Meal Centre North Facing","Salem(C), D 8, Kannakurichi Main Road,Salem(C), D 8, M.G.R.Nagar,Salem(C), D
8, N.G.G.O.Colony Annexue"
224,783,9,0,792,324,345,AIADMK,21,"Sowrastra Primary School, Chairman Sadagopan Street, Salem- 636001, Main Hall of Terraced Building West Portion Facing
West","Salem (C), D 34, Newstreet1,Salem (C), D 35, Pudu Street 2"
207,826,6,0,832,354,376,AIADMK,22,"Indian Institute of Handloom Technology, Ponnammapet,
Salem-636001, West Portion of South Facing New Terraced Building Room-3 Part","Salem (C), D 11, Vasagasalai Street Main Road,Salem (C), D 11, Vasagasalai Street3"
128,424,4,0,428,176,199,AIADMK,23,"SCMC Suramangalam Zonal Branch Office (Library) Velasamy Street, South Facing Terraced Building Ground Floor Near
Computer Lab","Salem (C), D,27,Sulukku Pilliar Koil street,Salem (C), D.27,Arisipalayam Main Road,Salem (C), D.27,Longly Road"
132,580,3,0,583,235,258,AIADMK,23,"SCMC Middle School, Damodharan Street, Arisipalayam,
Middle Terraced Building western portion facing south","Salem (C), D.26,Madhaian Street,Salem (C), D.26,Muthialu Street,Salem (C),
D.26,Syedalistreet"
46,1207,9,0,1216,547,571,AIADMK,24,"PUES, Motankurichi, Kannakurichi, Asbestas Building Facing
West, North Wing","Kannankurichi (TP), Ward10, MottankurichiErikadu1"
120,577,1,0,578,243,267,AIADMK,24,"SCMC Ele.School, Kamraj Colony Peramanur, New Terraced
Building Southern Portion Facing West","Salem (C), D.15, Peramanoor Kamarajar Colony,Salem (C), D.16, Peramanoor
Perumal Koil Street"
238,881,9,0,890,379,404,AIADMK,25,"SCMC Ele. School, Marimuthu Street, Salem, West Portion of
North Facing Terraced Building","Salem (C), D.36,Krishnan Pudur"
195,401,2,0,403,173,199,AIADMK,26,"SCMC Urudhu Ele. School,Paavadi  Vellakuttai, Salem-636001, North Portion of East Facing Terraced Building","Salem (C), D 33, Chittupilliar Koil Street,Salem (C), D 33, Devendrapuram Street1,Salem (C), D 33, Devendrapuram Street2,Salem (C), D 33, Devendrapuram Street3,Salem (C), D 33, Pochin Road"
225,648,0,0,648,285,312,AIADMK,27,"Sowrastra Primary School, Chairman Sadagopan Street, Salem- 636001, Terraced Building Main Centre Hall Facing West","Salem (C), D 35, Carpet Street"
6,843,4,0,847,373,401,AIADMK,28,"CSI Polytechnic College, Yercaud Main Road, Salem-636007, Southern Terraced Building North Facing Hall-DHG-2","Salem (C), D 7, Kannankurichi Main Road,Salem(C), D 7 Kallikadu (Kudisai Area),Salem(C), D 7 Kallikkadu"
131,629,4,0,633,241,269,AIADMK,28,"SCMC Middle School, Damodharan Street, Arisipalayam, New Terraced Building East Portion Facing South","Salem (C), D.26,Damodaran Street,Salem (C), D.26,Govindan Street,Salem (C), D.26,Kabinistreet,Salem (C), D.26,Veeraragavan Street"
113,330,2,0,332,127,158,AIADMK,31,"Cluny Matriculation HSS, Pudur Extension, Centre Portion of the Terraced Building Facing North 2nd Room (X-B Class Room)","Salem (C), D.13, Anna Nagar,Salem (C), D.13, Saradha College Road,Salem (C), D.16,Iyanarappan Koil Street"
240,555,8,0,563,229,260,AIADMK,31,"SCMC Middle School, Ellappan Street, 2nd Room of the
Northern Side Facing West Terraced Building","Salem (C), D 36, Achimuthu Street,Salem (C), D 36, Kandasamy Street,Salem (C),
D 36, Military Street"
221,1032,10,0,1042,432,464,AIADMK,32,"SCMC Ele School, Sengal Anai Road-636001, Terraced Building
Facing South West wing (Near HM Room)","Salem (C), D 10, Puthumariamman Koil Street3"
220,976,11,0,987,408,441,AIADMK,33,"SCMC High School, Sengal Anai Road, Salem-636001, East Portion of South Facing Terraced Building East Wing","Salem (C), D 10, Puthu mariamman koil Street2 (Thandavan naga,Salem (C), D 10, Puthumariamman koil Street2 (Sakthi Nagar)"
146,629,4,0,633,273,308,AIADMK,35,"SCMC Ele.School, Narasimman Road Shevapet 636002, New
Terraced Building Facing East Northern portion","Salem (C), D.28,Narasimman Road,Salem (C), D.28,Narasimman Road (Soukku
Thoppu)"
256,881,6,0,887,372,407,AIADMK,35,"SCMC High School, Vaikkalpattarai, Ammapet North, Salem-
636003, Terraced Building South Wing Facing East","Salem (C), D.9, Ramamoorthy pudur"
27,651,8,0,659,268,304,AIADMK,36,"SCMC Ele.School, Periya Kollapatty, Salem-636008, West
Portion of South Facing Self Sufficent Building","Salem (C), D 6. Syndicate Colony Kurnichi Nagar 1,2 SakthiNagar
Annex,Salem(C), D 6  Ramasamy Nagar IInd Cross"
185,826,2,0,828,348,385,AIADMK,37,"SCMC Middle School Employees Thirft Co Op Society Car Street
2ndAgraharam, Facing East North Portion","Salem (C), D 32, Arasamaram Pilliar Koil North Street,Salem (C), D 32, Kutti
vaithiar Street,Salem (C), D 32, Riverside Street"
36,812,1,0,813,365,403,AIADMK,38,"PUMS, Kannankurichi, Terraced Building Facing West, South Wing","Kannankurichi (TP), Ward7, Ammaiappan Street,Kannankurichi (TP), Ward7, Arumugam Street,Kannankurichi (TP), Ward7, K.S.Arumugam Street,Kannankurichi (TP), Ward7, Kandasamy Street,Kannankurichi (TP), Ward7, Seerangan Street,Kannankurichi (TP), Ward8, Arunachalam Street No.3,Kannankurichi (TP), Ward8, PerumalKoil Street"
217,683,6,0,689,288,326,AIADMK,38,"SCMC Ele. School, Sengal Anai Road, Salem-636001, North
Facing New RMSA Building Room no 4","Salem (C), D 10, Puthumariamman Koil Street1"
243,1038,5,0,1043,436,474,AIADMK,38,"SCMC Middle School, Ellappan Street, Salem-636003, Facing East South Wing Terraced Building","Salem (C), D 36, Ellappan Street,Salem (C), D 36, Kolandan Street,Salem (C), D 36, PandariNathar Street1,Salem (C), D 36, Pandarinathar Street2"
90,507,7,0,514,205,244,AIADMK,39,"SCMC Ele.School, Kumarasamypatty,Cherry Road, Salem-
636007, Facing West Terraced Building South Wing","Salem (C), D.15, Raja Extension,Salem (C), D.15, Seerangapalayam Main Road"
64,654,6,0,660,259,299,AIADMK,40,"SCMC Middle School, Chinnathirupathi, New Building Facing
South, West Wing","Salem(C), D  8 ,Ashok Nagar,Salem(C), D  8 Vettukadu,Salem(C), D 8 ,Annamalai
Nagar,Salem(C), D 8 Maruthi Nagar"
219,697,7,0,704,296,336,AIADMK,40,"SCMC High School  Sengal Anai Road, Salem-636001, Terraced Building Facing South, West Wing (Near HM Room)","Salem (C), D 10, Puthumariamman Koil Street2"
9,658,7,0,665,259,300,AIADMK,41,"CSI Hobert GHS School Hasthampatty Salem-636007, Facing
South Terraced Building West Portion","Salem (C), D.13,Central Jail Backside"
47,433,3,0,436,189,230,AIADMK,41,"PUES, Motankurichi Kannakurichi, Asbestas Building Facing
West, South Wing","Kannankurichi  (TP), Ward10, Mottankurichimurugankoil2"
241,774,6,0,780,323,364,AIADMK,41,"SCMC Middle School, Ellappan Street, Salem-636003, 3rd Room of West Facing Terraced Building","Salem (C), D 36, Adhiselvaganapathy Street,Salem (C), D 36, Adhiselvan Street,Salem (C), D 36, Kandappan Street,Salem (C), D 36, Muniappan Koil
Street,Salem (C), D 36, Venkatachalam Street"
262,775,4,0,779,337,378,AIADMK,41,"SCMC Middle School, Allikuttai, Salem-636003, South Portion
of West Facing Terraced Building","Salem (C), DIV,9, Allikuttai,Salem (C), DIV9, mariamman kovil street"
206,433,0,0,433,176,218,AIADMK,42,"Indian Institute of Handloom Technology, Ponnammapet, Addl. New Building Facing South West Wing Second Room Part","Salem (C), D 11, Anairoad,Salem (C), D 11, I.I.H.T.Quarters,Salem (C), D 11, Thillainagar 1st cross,Salem (C), D 11, Thillainagar Main Road"
160,695,7,0,702,284,328,AIADMK,44,"Vasavi Ele School, Andal Street, Shevapet, Salem-636002, East Facing Room No.1 North Portion of Terraced Building","Salem (C), D.30,Mariamman Koil Street,Salem (C), D.30,Muthusamy Street,Salem (C), D.30,Pilliar Koil Street"
184,646,5,0,651,256,300,AIADMK,44,"SCMC Middle School, Car Street, 2nd Agraharam-636001,
North Hall East Side Room Facing south","Salem (C), D 32, Arasamaram Pilliar Koil Street,Salem (C), D 32, Kasimuniappan
Koil Street,Salem (C), D 32, Sankaralayam Road"
39,802,7,0,809,326,371,AIADMK,45,"GHSS, Kannankurichi, Salem-636008, East Portion of South
Facing Terraced Building Room No 18","Kannankurichi (TP), Ward14, PacharoadYercaudmain Road"
13,741,4,0,745,311,357,AIADMK,46,"SCMC Ele. School, Ayyanthirumaligai Salem-636007, Anganwadi New Terraced Building Facing West East Wing","Salem (C), D.7,First Street,Salem (C), D.7,Housing Unit Itteri Road,Salem (C), D.7,Keel Street,Salem (C), D.7,Nadustreet,Salem (C), D.7,Second Street,Salem (C), D.7,Syndicate Bank Colony,Salem (C), D.7,Vallalar Nagar"
122,626,4,0,630,252,298,AIADMK,46,"Little Flower Matriculation School, Chariman Thammannan Road, Salem-636009, West Portion of South Facing Terraced
Building","Salem (C), D.27, Omalur Road (Rathinasamipuram)"
3,796,7,0,803,336,384,AIADMK,48,"Anderson Matric Hr.Sec.School, Sengodagounder salai Salem, North Facing Terraced Building South Wing Room No 2A","Salem (C), D.7,Attukadu (Backside of Collector Bungalow),Salem (C), D.7,Sengodagounder  Salai"
201,715,4,0,719,293,342,AIADMK,49,"SCMC Ele. School, Paramakudi Nannusamy Street, Salem-
636001, Terraced Building North Facing","Salem (C), D 34, Kanagaraj Ganapathy Street,Salem (C), D 34, Natesan Street"
23,872,7,0,879,367,419,AIADMK,52,"SCMC Sainitory Inspector Office (Veterinary Hospital) Periya
Kollapatty., Facing West Terraced Building","Salem(C), D 6  Angalamman koil street,Salem(C), D 6  Mariammankoil
Street,Salem(C), D 6  Subramaniar koil Street"
96,509,4,0,513,197,250,AIADMK,53,"SCMC Girls HS, Sagadevapruam, New Terraced Building Facing
South West Wing of North Side","Salem (C), D.14, Shankar Nagar,Salem (C), D.14, Shankar Nagar (Swarna
Upartment)"
163,503,6,0,509,192,250,AIADMK,58,"SCMC High School, Appu Street, Shevapet, Salem-636002, East Side 2nd Room of South Facing Terraced Building","Salem (C), D 30, Appustreet,Salem (C), D 30, Sundaram Street"
239,413,5,0,418,154,212,AIADMK,58,"SCMC Ele. School, Marimuthu Street,, North Facing Terraced
Building East Wing","Salem (C), D.36,Krishnan Pudur"
105,355,2,0,357,128,187,AIADMK,59,"SCMC Ele. School, Sivasamypuram No-2, Srirangapalayam, Salem-636007, East Portion of west Facing Anganwadi
Terraced Building","Salem (C), D.15, Peramanoor East Street"
162,536,4,0,540,202,261,AIADMK,59,"SCMC HS, Appu Street-636002, Terraced Building Facing South
3rd Room from Eastern Side","Salem (C), D.30, Madhavarayan Street,Salem (C), D.30, Venkatakrishnan Street"
95,363,3,0,366,132,192,AIADMK,60,"SCMC Girls HS, Sagadevapruam-636007, New Terraced
Building Western Building South Wing Facing East","Salem (C), D.14,Rajaram Nagar,Salem (C), D.14,Shankar Nagar (OdaiArea)"
251,922,12,0,934,378,438,AIADMK,60,"SCMC Ele School, Vaikkalpattarai Ammapet North, Salem- 636003, New Terraced Building Facing South, East Wing","Salem (C), D.9, Puduvalaivu,Salem (C), D.9, Vaikalpattarai,Salem (C), D.9,Seelavari Erattaikinaru"
214,554,1,0,555,225,286,AIADMK,61,"SCMC Ele School, Sengal Anai Road, Salem-636001, East
Portion of North Facing Terraced Building Room No-1","Salem (C), D 10, Railway line north street2,Salem (C), D 10, Railwayline North
Street1"
97,631,5,0,636,244,307,AIADMK,63,"SCMC Girls HS, Sagadevapruam, New Terraced Building East
Wing of the northern side Building Facing South","Salem (C), D.14, Shankar Nagar,Salem (C), D.14, Shankar Nagar (Temporary
House)"
153,834,3,0,837,321,384,AIADMK,63,"St. Patricks Primary Girls School ABL, I-A,  Shevapet, Salem- 636002, Facing South Terraced Building Middle Wing","Salem (C), D.28,Chairman Jaganathan Street,Salem (C), D.28,Deivanayagam Street,Salem (C), D.28,Sandaipet Main road"
234,691,3,0,694,283,346,AIADMK,63,"SCMC Ele. School, T.V.K.Road, Salem-636003, Terraced
Building Facing North West Wing","Salem (C), D 36, Govindarajan Street,Salem (C), D 36, Pidariamman Koil
Street,Salem (C), D 36, Shanmugam Street"
252,895,14,0,909,351,414,AIADMK,63,"SCMC Ele School, Vaikkalpattarai Ammapet North, Salem- 636003, New Terraced Building Facing South Centre Portion","Salem (C), D.9, Modern Buildings,Salem (C), D.9, N.G.G.O. Colony,Salem (C),
D.9, Seelavari Tamilnadu Housing Board,Salem (C), D.9, Thathampatty,Salem (C), D.9,Poonjolai Village"
21,668,2,0,670,275,339,AIADMK,64,"Mountmary s Matriculation School, Periyar Nagar (Room No.7) Chinnakollapatty, Terraced Building Facing South, Middle Wing","Salem(C), D 6  Ayyankadu,Salem(C), D 6  Periyar nagar"
91,695,5,0,700,267,332,AIADMK,65,"SCMC Ele.School, Kumarasamypatty,Cherry Road, Salem- 636007, Noon Meal Centre Terraced Building East Facing South
Portion","Salem (C), D.14, Setu Extension,Salem (C), D.14, Venkatesapuram"
255,1164,7,0,1171,506,576,AIADMK,70,"Sri Vivekananda Patasalai Matriculation School, Sathya Nagar
North Ammapet Salem-636003, Terraced Building Facing North (Room No.3)","Salem (C), D.9, Krishnapudur koyyathoppu"
150,638,11,0,649,246,317,AIADMK,71,"Jayarakini Boys Middle School, Santhaipetti Main Road,
Terraced Building Facing South, East Wing","Salem (C), D.28,Appasamy Street,Salem (C), D.28,Rajavadhani Street,Salem (C),
D.28,Vela Street,Salem (C), D.30,Narayanan Street"
161,397,3,0,400,140,211,AIADMK,71,"Vasavi Ele School, Andal Street, Shevapet, Salem-636002, South Portion Room No.2 of East Facing Terraced Building","Salem (C), D.30,Andal Street,Salem (C), D.30,Thandan Street,Salem (C), D.30,Thiruvalluvar Street"
205,758,7,0,765,296,368,AIADMK,72,"Indian Institute of Handloom Technology, Ponnammapet, Terraced Building West Portion South Facing Room No 1 (part)","Salem (C), D 11, Vasagasalai Street1,Salem (C), D 11, Vasagasalai Street2 (Singarapet)"
100,560,4,0,564,203,276,AIADMK,73,"SCMC Ele. School No.1, Ram Nagar, Kumarasamypatty, Salem- 636007, South Portion of East Facing Terraced Building","Salem (C), D.14,Kumarasamypatty West Street2,Salem (C), D.15,Rajagopalachariar Road"
250,980,10,0,990,407,480,AIADMK,73,"Sri Vivekananda Patasalai Matriculation School, Sathya Nagar North Ammapet Salem-636003, Terraced Building Facing
North (Room No.2)","Salem (C), D.9, Indira nagar,Salem (C), D.9, Sathya nagar,Salem (C), D.9, Seelavari Earikarai"
25,826,2,0,828,328,403,AIADMK,75,"SCMC Ele. School, Periya Kollapatty, Facing North Terraced
Building West Wing","Salem(C), D 6  Gandhinagar and new colony periakollappatty"
143,571,5,0,576,209,284,AIADMK,75,"28th Division Sanitary Inspector Office, Chariman Ayyasamy Road, Paal Market Family Welfare Extn. Officer Training Centre Compound,Salem-636002, South Facing Terraced Building","Salem (C), D.28, Angalamman Koil Street,Salem (C), D.28, Kasi Viswanathan Street,Salem (C), D.28, Mari Street"
121,640,4,0,644,246,322,AIADMK,76,"SCMC Ele.School, Kamraj Colony Peramanur, New Terraced
Building Facing West Northern portion","Salem (C), D.16.Peramanoor (Chari Area),Salem (C), D.16.Peramanoor
Mariamman Koil Street"
130,580,5,0,585,221,298,AIADMK,77,"SCMC Suramangalam Zonal Branch Office (Library) Velasamy Street, Western Portion of The Terrached Building Facing
North","Salem (C), D.27,Chinnappan Street"
265,664,6,0,670,260,340,AIADMK,80,"SCMC Middle School, Allikuttai, Salem-636003, Terraced
Building Facing South East Wing","Salem (C), D,9, seloan colony, ganapathi nagar,Salem (C), DIV9, Aasari
kadu,Salem (C), DIV9, Ramamurthi pudur"
233,1013,12,0,1025,408,489,AIADMK,81,"SCMC Ele.School, T.V.K.Road, Terraced Building Facing East","Salem (C), D 35, Market Street1,Salem (C), D35, Rajaganapathy Street"
216,783,4,0,787,298,383,AIADMK,85,"SCMC High School, Sengal Anai Road, Salem-636001, New
Terraced Building Western Wing Facing South","Salem (C), D 10, Desiapunaramaippu Colony,Salem (C), D 10, Vasagasalai Street"
124,583,1,0,584,204,294,AIADMK,90,"Little Flower Metriculation School, Chairman Thammannan Road, Salem-636009, East Portion of South Facing Terraced
Building","Salem (C), D.27,Chairman Thammannan Road"
248,680,3,0,683,259,349,AIADMK,90,"SCMC Ele. School, Adhiselvan Street, Ammapet, Salem-636003, 3rd Room of North Facing New Terraced Building","Salem (C), D36, Cuddalore main road south extension"
65,928,12,0,940,357,451,AIADMK,94,"SCMC Middle.School, Chinnathirupathi, Facing South Terraced Building East Wing","Salem(C), D 8, Logu Nagar,Salem(C), D 8, Mookaneri Adikerai Porampoku
,Salem(C), D 8, N.G.G.O.Colony,Salem(C), D 8, Yerikarai Road"
84,759,5,0,764,304,401,AIADMK,97,"SCMC Ele.School, Manakkadu, Terraced Building Facing West,
Eastern side of North Wing","Salem (C), D.12,Manakkadu Mariamman Koil Street,Salem (C), D.13,Manakadu
South Street"
148,544,4,0,548,202,301,AIADMK,99,"SCMC Middle School, Narasimman Road, Shevapet,-636002, New Terraced Building Facing East Southern Portion","Salem (C), D.28,Narasimman Road,Salem (C), D.28,Narasimman Road (Appartments),Salem (C), D.28,Narasimman Road(Kudisai Paguthi)"
111,815,4,0,819,318,421,AIADMK,103,"Cluny Matriculation HSS, Pudur Extension,Salem-636007,
Terraced Building Room No 5 South Facing North Building (XII- A Class Room)","Salem (C), D.16, Chinnapudur"
106,662,8,0,670,214,319,AIADMK,105,"Cluny Matriculation School, Pudur Extension, Northern Side, East Portion 1st Room.Facing south (XI-B Class Room)","Salem (C), D.13, M.D.S.Nagar,Salem (C), D.13, Seetharam Avenue,Salem (C), D.15, Ramakrishna Road,Salem (C), D.15, Vidhyalaya Road"
249,995,7,0,1002,408,514,AIADMK,106,"Sri Vivekananda Patasalai Matriculation School, Sathya Nagar
North Ammapet Salem-636003, Terraced Building Facing North (Room No.1)","Salem (C), D,9, M.G.R. Nagar,Salem (C), D.9, Mannarpalayam,Salem (C), D.9, Sathya nagar"
186,569,12,0,581,185,296,AIADMK,111,"SCMC Middle School, Car Street, Salem-636001, South Portion of East Facing Noon Meal Centre Terraced Building","Salem (C), D 32, Car Street,Salem (C), D 32, Milakaikara Street,Salem (C), D 32, Narayanan Street,Salem (C), D 32, Second Agraharam,Salem (C), D 32,
Sidhanstreet"
215,556,1,0,557,201,312,AIADMK,111,"SCMC Ele School, Sengal Anai Road, Salem-636001, 2nd Room
of North Facing New Terraced Building","Salem (C), D 10, Railway line North Street4,Salem (C), D 10, Railwayline North
Street3"
242,952,16,0,968,365,483,AIADMK,118,"SCMC Middle. School, Ellappan Street, Salem-636003, West Facing Terraced Building Room No 4","Salem (C), D 35, Kaveri Street,Salem (C), D 36, Kanagasabapathy Street,Salem (C), D 36, Narayanan Street,Salem (C), D 36, Sankaran Kadu,Salem (C), D 36, Sundaraganapathy Street,Salem (C), D 36, Vyapuri Street"
129,769,0,0,769,291,412,AIADMK,121,"SCMC Suramangalam Zonal Branch Office (Library) Velasamy Street, East portion  of the Terraced Building Facing North","Salem (C), D.27,Chinnappan Street"
264,886,8,0,894,350,471,AIADMK,121,"SCMC Middle School, Allikuttai, Salem-636003, West Portion
South Facing Terraced Building Middle Wing","Salem (C), D,9,Mannarpalayam X Road,Allikuttai,Salem (C), D,9,Poyar Street
Aalamarathur, Allaikuttai"
145,446,5,0,451,130,260,AIADMK,130,"SCMC Noon Meal  Center, Ayyasamy Road , Paal Market, West
Facing Asbestors Building","Salem (C), D.28,Bangaru Street,Salem (C), D.28,Longly Road,Salem (C),
D.28,Navalar Nedunjezhian Road,Salem (C), D.28,Shevapet Agraharam"
155,622,8,0,630,208,338,AIADMK,130,"Manurkula Devanga Ele.School, Vasagasalai Street, Eastern Portion Facing South Terraced Building","Salem (C), D.28,Chennakrishnan Street,Salem (C), D.28,Kuppusamy Street,Salem (C), D.28,Longly Road StreetNo.2,Salem (C), D.28,Longly Road
StreetNo.3,Salem (C), D.28,NallaThangal Street"
149,662,4,0,666,247,380,AIADMK,133,"Jayarakini Boys Middle School, Santhaipetti Main Road-
636002, Terraced Building Facing North, South Building","Salem (C), D.28,Narasimman Road"
212,924,3,0,927,341,475,AIADMK,134,"SCMC Ele. School, Sengal Anai Road, Salem-636001, 3rd Room
From West Side of North Facing Terraced Building","Salem (C), D 10, P.L.Gopal Street,Salem (C), D 10, Puthumariamman koil Street
(Pandian Street)"
208,893,7,0,900,315,450,AIADMK,135,"Indian Institute of Handloom Technology, Ponnammapet, Salem-636001, Main Entrance of South Facing Terraced
Building Room No-3","Salem (C), D 11, Thillainagar 3rd Cross,Salem (C), D 11, Thillainagar Street2,Salem (C), D 11, Vasagasalai Street4"
236,763,5,0,768,264,401,AIADMK,137,"Village Chavadi, TVK.Road, Salem-636003, East Facing Terraced
Building","Salem (C), D 35, Market Street2"
263,929,7,0,936,346,484,AIADMK,138,"SCMC Middle School, Allikuttai, Salem-636003, Terraced
Building Facing West North Wing","Salem (C), D,9, Muthugoundan Street, Allikuttai,Salem (C), D,9, Valluvar colony"
17,920,6,0,926,326,468,AIADMK,142,"SCMC Middle School, Chinna Kollapatty, Salem-636008,
Terraced Building Facing South,  East Wing","Salem(C), D 6 Annasalai,Salem(C), D 6 Boyarstreet,Salem(C), D 6
G.K.V.Nagar,Salem(C), D 6 Saraswathinagar,Salem(C), D 6 Varmagarden"
178,589,4,0,593,180,324,AIADMK,144,"Gokulanatha Hindu Mahajana,HSS, Salem, Terraced Main Building Facing North, Eastern Portion Hall No 1","Salem (C), D.29,Dr.Ramanathan Street,Salem (C), D.29,SivaSami Street,Salem (C), D.29,Sornambigai Street,Salem (C), D.29Town Railway Station Road"
259,899,3,0,902,346,494,AIADMK,148,"SCMC Middle School, Allikuttai, New Terraced Building Facing
West East Middle Wing","Salem (C), D,9, Allikuttai,Salem (C), D,9, Gangapudur,Salem (C), D,9, kangapudur"
144,416,4,0,420,108,261,AIADMK,153,"28th Division Sanitary Inspector Office, Chariman Ayyasamy Road, Paal Market Family Welfare Extn. Officer Training Centre Compound, Salem-636002, North Facing Terraced Building","Salem (C), D.28, Chairman Ayyasamy Street,Salem (C), D.28, Police Petrol Road,Salem (C), D.28, Venkatraman Street"
92,701,9,0,710,234,390,AIADMK,156,"SCMC Girls HS, Sagadevapruam, Terraced Building Facing South, West Wing","Salem (C), D.14, Chairman Chinnia Road,Salem (C), D.14, Maravaneri Cross Street7,Salem (C), D.14, Natesan Colony,Salem (C), D.14, Udayappa Colony"
107,717,12,0,729,206,367,AIADMK,161,"Sarada BalaMandir HSS, Rajaji Road. (Kiruba Hospital Road), West Facing Terraced Building, Block 6, LKG-C Section","Salem (C), D.14,Chennakrishnapuram,Salem (C), D.15,Gandhi Road,Salem (C), D.15,Lakshmipuram"
204,582,9,0,591,169,334,AIADMK,165,"SCMC Ele School, Paramakudi Nannusamy street-636001, Terraced Building Facing North Western Side Last Room","Salem (C), D 34, Pillaiyar koil street 1"
254,725,7,0,732,243,408,AIADMK,165,"SCMC High School, Vaikkalpattarai Ammapet North, Salem-
636003, South Portion of north wing facing East","Salem (C), D.9, Valkadu,Salem (C), D.9. Sengal anai road"
261,931,8,0,939,347,513,AIADMK,166,"SCMC Middle School, Allikuttai, Salem-636003, New Terraced
Building Facing West, Northern Wing","Salem (C), D.9,Kondon Thoppu,Salem (C), DIV9, alikuttai main road"
159,666,4,0,670,207,379,AIADMK,172,"Manurkula Devanga Ele.School, Vasagasalai Street, Terraced Building Facing South, Western Wing","Salem (C), D.29.Chairman Venkadappan Road,Salem (C), D.29.Devangapuram Extension,Salem (C), D.29.Devangapuram Newstreet,Salem (C), D.29.Devangapuram Street (G.H.Backside),Salem (C), D.29.Jambulingam Street"
168,672,2,0,674,218,393,AIADMK,175,"Govt. Blind School, Bungalow Street, Shevapet,Salem-636002,
South Facing East Side Terraced Building","Salem (C), D.30,Bungalow Street,Salem (C), D.30,Nandavanam Street"
267,943,11,0,954,340,515,AIADMK,175,"SCMC Middle School, Allikuttai, Terraced Building Facing North
East wing","Salem (C), D,9, Gandhi nagar,Salem (C), D,9, Sootaiya goundar street"
98,501,4,0,505,118,295,AIADMK,177,"SCMC Girls HS, Sagadevapruam-636007, New Terraced Building Middle Wing of the Western Side Building Facing East","Salem  (C), D.14,Cherararajan Road,Salem (C), D.14,Maravaneri  Cross Street5,Salem (C), D.14,Maravaneri Cross Street1,Salem (C), D.14,Maravaneri Cross Street3,Salem (C), D.14,Maravaneri Cross Street4,Salem (C), D.14,Maravaneri CrossStreet6,Salem(C), D.14,Maravaneri Cross
Street2,Salem(C), D.14,Sagadevapuram"
125,813,4,0,817,281,459,AIADMK,178,"Little Flower Matriculation School, Chairman Thammanan Road, Facing North Terraced Building 3rd Room From East Side","Salem (C), D.27,Chairman Thammannan Road Mullakkadu,Salem (C), D.27,Chairman Thammannan Road Thailangadu"
12,1020,7,0,1027,370,554,AIADMK,184,"SCMC Ele.School, Ayyanthirumaligai-636007, Facing North
Building Eastern Wing","Salem (C), D.7,IyyenThirumaligai,Salem (C), D.7,Kuzhandaigal Nala Kappaga
Street,Salem (C), D.7,MalStreet"
147,537,3,0,540,152,336,AIADMK,184,"SCMC Middle School, Narasimman Road Shevapet, Terraced
Building Facing East Middle portion","Salem (C), D.28,Narasimman Road"
167,726,7,0,733,238,423,AIADMK,185,"Sowrastra Vidhayala Middle School,Manickam Street, Shevapet-636002, Facing East, Third Portion","Salem (C), D 30, Arokiyanathar Street,Salem (C), D 30, Manickam Street,Salem (C), D 30, Muthansubbaiar Street,Salem (C), D 30, Seshasalam Street,Salem (C),
D 30, Syedmathar Street"
63,957,7,0,964,332,521,AIADMK,189,"Jairam Higher Secondary School Chinnathirupathi, West Facing
Terraced Building Room No 10","Salem(C), D 8  Amman nagar,Salem(C), D 8  Ayyanarkoil kadu,Salem(C), D 8
Srivishnupathy Nagar"
268,981,6,0,987,353,542,AIADMK,189,"SCMC Middle School, Allikuttai, Salem-636003, West Portion
of North Facing Terraced Building","Salem (C), D,9, Chinna Ammapattai,Salem (C), D,9, Jai matric school,Salem (C),
D,9, Narasinman kovil  street"
28,831,9,0,840,268,463,AIADMK,195,"SCMC Ele.School, Periya Kollapatty, Salem-636008, East
Portion of South Facing Self Sufficent Building","Salem (C), D 6. Patchiamman Kovil, Kamarajar Road Jallikadu"
169,453,2,0,455,109,311,AIADMK,202,"Govt. Blind School, Bungalow Street, Shevapet,Salem-636002, Centre Portion of South Facing New Terraced Building","Salem (C), D.30,Saibaba Street,Salem (C), D.30,Vasulu street"
203,863,13,0,876,283,485,AIADMK,202,"SCMC Ele School, Paramakudi Nannusamy Steet-636001,
Terraced Building West Portion Facing East North Wing","Salem (C), D 34, Chairman Sadagopan Street,Salem (C), D 35, Pillaiyar koil street
2"
165,621,2,0,623,177,380,AIADMK,203,"SCMC High School, Appu Street, Salem-636002, West Portion
of North Facing Terraced Building","Salem (C), D.30, Bharathidasan Street,Salem (C), D.30, Kabilar Street"
253,638,3,0,641,187,393,AIADMK,206,"SCMC Ele School, Vaikkalpattarai Ammapet North, Salem- 636003, New Terraced Building Facing South west Potion","Salem ©, D.9. Sengal anai road"
15,935,8,0,943,326,534,AIADMK,208,"SCMC Middle School, Chinnakollapatty, Facing South Terraced Building, West Wing","Salem(C), D 6 Yercaud Main Road, Gandhi Nagar East, Jeeva Street,Salem(C), D 6, Annaiindiranagar,Salem(C), D 6, Gandhistreet,Salem(C), D 6, Jeevathstreet,Salem(C), D 6, Thiruvalluvarnagar"
18,756,4,0,760,248,461,AIADMK,213,"SCMC Middle School, Chinnakollapatty, Building Facing South,
East Wing","Salem(C), D 6  Kaliammannagar,Salem(C), D 6 Pazhaniappakounder,Salem(C),
D6 Yercaudmainroad"
166,679,4,0,683,202,423,AIADMK,221,"Sowrastra Vidhayala Middle School, Manickam Street, Shevapet, Salem-636002, First Portion of East Facing Terraced Building","Salem (C), D.30,Adhiraman Nandavanam Street,Salem (C), D.30,Kandasamy Pillai Street1,Salem (C), D.30,Kandasamy Pillai Street2,Salem (C), D.30,Mannar Nandavanam Street,Salem (C), D.30,Muthavalli Ibrahim Street,Salem (C), D.30,Panduranganathar Koil  Street"
109,760,12,0,772,221,445,AIADMK,224,"Cluny Matriculation HSS, Pudur Extension, Salem-636007, South Facing 3rd Room of North Terraced Building (XII-C Class
Room)","Salem (C), D.15,Vijayaragavachariar Road,Salem (C), D.16, Chinnapudur"
196,755,14,0,769,210,437,AIADMK,227,"SCMC Ele.School, Bazaar Street,, Anna Pavazha Vizha Building
Facing South Terraced building","Salem (C), D 34, Krishnan Koil Sandhu,Salem (C), D 34, Krishnan Koil Street"
157,943,12,0,955,321,554,AIADMK,233,"Manurkula Devanga High School Shevapet-636002, East Wing Facing North Terraced Building","Salem (C), D 29, Arthanari Street,Salem (C), D 29, Arunachalam Street,Salem (C), D 29, Devanga Pilliar Koil Street,Salem (C), D 29, Sambalinga Moorthy
Street,Salem (C), D 29, Vasagasalai Street"
198,776,9,0,785,213,448,AIADMK,235,"Salem City SSV Nursery School, Murari Varadaiyer Street,
Terraced Building East Facing Middle Wing","Salem (C), D 34, Pennadam Venkatraman Street,Salem (C), D 34, Poochangottai
Street"
199,1005,11,0,1016,306,542,AIADMK,236,"SCMC Ele School, Paramakudi Nannusamy Street-636001,
Ground Floor Facing North East Wing","Salem (C), D 34, Paramakudi Nannusamy Street,Salem (C), D 34, Putta Nagaier
Street"
108,800,5,0,805,231,506,AIADMK,275,"Cluny Matriculation HS School, Pudur Extension, Salem 636007, West Portion of 2nd Room Facing South (XI-A Class
Room)","Salem (C), D.13, Uma Nagar,Salem (C), D.13, Vivekananda Nagar,Salem (C), D.16, Chinnapudur"
50,986,6,0,992,309,612,AIADMK,303,"Suba Primary School, Mahendrapuri, West Terraced Building
East Facing Room No.1","Salem (C), D 8, Gandhinagar,Salem(C), D 8,Annasalai East"
156,604,4,0,608,111,423,AIADMK,312,"Manurkula Devanga Ele.School, Vasagasalai Street-636002, Terraced Building South Facing Middle Portion","Salem (C), D.29,Govindan Street,Salem (C), D.29,Lakshmi Iyer Street,Salem (C), D.29,Managuru Gopalsamy Street,Salem (C), D.29,Muniappan Koil Street,Salem (C), D.29,Navalar Nedunchezhian Salai,Salem (C), D.29,Rudrappan Street"
197,949,15,0,964,242,581,AIADMK,339,"Salem City SSV Nursery School,Murari Varadaiyar Street,
Terraced Building Facing East, East Wing","Salem (C), D  34, Bungalow Street,Salem (C), D 34, Murarivaradhaiar
Street,Salem (C), D 34, Third Agraharam"
158,953,15,0,968,257,597,AIADMK,340,"Manurkula Devanga High School, Shevapet-636002, West Wing Facing North Terraced Building","Salem (C), D.29,Kumarasamy Street,Salem (C), D.29,Madurai Kuppaiar Street,Salem (C), D.29,Pethapai Sandu,Salem (C), D.29,Rendala Govindan Street,Salem (C), D.29,Thottuchandraiar street,Salem (C), D.29,Vaithi Street"
170,863,1,0,864,177,598,AIADMK,421,"Govt. Blind School, Shevapet Salem-636002, Northern Buildingt East Portion Facing South","Salem (C), D 30, Achuraman Street,Salem (C), D 30, Adhiraman Street,Salem (C), D 30, Adhivenkatachalapathy Street,Salem (C), D 30, Thandavarayan
Street,Salem (C), D 30, Venkatraman Street"
